1948 Tucker Sedan	/wiki/1948_Tucker_Sedan
AC Cars	/wiki/AC_Cars
AGA (automobile)	/wiki/AGA_(automobile)
AMZ-KUTNO Ltd	/wiki/AMZ-KUTNO_Ltd
APIS (automobiles)	/wiki/APIS_(automobiles)
ARO	/wiki/ARO
ASA (automobile)	/wiki/ASA_(automobile)
Abadal	/wiki/Abadal
Abarth	/wiki/Abarth
Acadian (automobile)	/wiki/Acadian_(automobile)
Acura	/wiki/Acura
Adam Motor Company	/wiki/Adam_Motor_Company
Adams-Farwell	/wiki/Adams-Farwell
Adler (automobile)	/wiki/Adler_(automobile)
Advanced Automotive Design	/wiki/Advanced_Automotive_Design
Advanced Automotive Design	/wiki/Advanced_Automotive_Design
Aero (automobile)	/wiki/Aero_(automobile)
Aerocarene	/wiki/Aerocarene
Agrale	/wiki/Agrale
Aixam	/wiki/Aixam
Al-Ghazi Tractors	/wiki/Al-Ghazi_Tractors
Alco	/wiki/Alco
Alfa Romeo	/wiki/Alfa_Romeo
Almazora Motors Corporation	/wiki/Almazora_Motors_Corporation
Alpina	/wiki/Alpina
Alpine (automobile)	/wiki/Alpine_(automobile)
Alta (vehicles)	/wiki/Alta_(vehicles)
American Motors	/wiki/American_Motors
American Simplex	/wiki/American_Simplex
Amur (company)	/wiki/Amur_(company)
Anadol	/wiki/Anadol
Ansaldo (car)	/wiki/Ansaldo_(car)
Anziel Nova	/wiki/Anziel_Nova
Apollo (1962 automobile)	/wiki/Apollo_(1962_automobile)
Apollo Automobil	/wiki/Apollo_Automobil
Apollo Automobil	/wiki/Apollo_Automobil
Apperson	/wiki/Apperson
Aptera Motors	/wiki/Aptera_Motors
Aquila Italiana	/wiki/Aquila_Italiana
ArBenz	/wiki/ArBenz
Ariel Motor Company	/wiki/Ariel_Motor_Company
Arrinera	/wiki/Arrinera
Artega Automobile	/wiki/Artega_Automobile
Asahi (automobile)	/wiki/Asahi_(automobile)
Ashok Leyland	/wiki/Ashok_Leyland
Asia Motors	/wiki/Asia_Motors
Aspid	/wiki/Aspid
Aston Martin	/wiki/Aston_Martin
Asüna	/wiki/As%C3%BCna
Atlas Honda	/wiki/Atlas_Honda
Attica (automobiles)	/wiki/Attica_(automobiles)
Auburn Automobile	/wiki/Auburn_Automobile
Audi	/wiki/Audi
Aurea (car)	/wiki/Aurea_(car)
Austro-Fiat	/wiki/Austro-Fiat
Auto Union	/wiki/Auto_Union
Autobacs Seven	/wiki/Autobacs_Seven
Autobianchi	/wiki/Autobianchi
Autocars Co.	/wiki/Autocars_Co.
Autokinitoviomihania Ellados	/wiki/Autokinitoviomihania_Ellados
Automeccanica	/wiki/Automeccanica
Automobile Dacia	/wiki/Automobile_Dacia
Automobili Turismo e Sport	/wiki/Automobili_Turismo_e_Sport
Autosan	/wiki/Autosan
Avia	/wiki/Avia
Avtoframos	/wiki/Avtoframos
Avtotor	/wiki/Avtotor
AzSamand	/wiki/AzSamand
BAW	/wiki/BAW
BIOMAN (lifting devices)	/wiki/BIOMAN_(lifting_devices)
BMC (Turkey)	/wiki/BMC_(Turkey)
BMW	/wiki/BMW
BYD Auto	/wiki/BYD_Auto
Bahman Group	/wiki/Bahman_Group
Bajaj Auto	/wiki/Bajaj_Auto
Baker Electric	/wiki/Baker_Electric
Balkania (trade name)	/wiki/Balkania_(trade_name)
Bandini Automobili	/wiki/Bandini_Automobili
Bangladesh Machine Tools Factory	/wiki/Bangladesh_Machine_Tools_Factory
Barkas (van manufacturer)	/wiki/Barkas_(van_manufacturer)
Bates (automobile)	/wiki/Bates_(automobile)
Bellanger	/wiki/Bellanger
Bentley	/wiki/Bentley
Berliet	/wiki/Berliet
BharatBenz	/wiki/BharatBenz
Biamax	/wiki/Biamax
Biotechnia Ellinikon Trikyklon	/wiki/Biotechnia_Ellinikon_Trikyklon
Bitter Cars	/wiki/Bitter_Cars
Bizzarrini	/wiki/Bizzarrini
Bogdan group	/wiki/Bogdan_group
Bolloré	/wiki/Bollor%C3%A9
Bombardier Recreational Products	/wiki/Bombardier_Recreational_Products
Borgward	/wiki/Borgward
Borgward Group	/wiki/Borgward_Group
Borland Racing Developments	/wiki/Borland_Racing_Developments
Bowler Offroad	/wiki/Bowler_Offroad
Brabham Automotive	/wiki/Brabham_Automotive
Brasinca Uirapuru	/wiki/Brasinca_Uirapuru
Bravia (automobile)	/wiki/Bravia_(automobile)
Bremach	/wiki/Bremach
Bremach	/wiki/Bremach
Brennabor	/wiki/Brennabor
Bricklin SV-1	/wiki/Bricklin_SV-1
Briggs Automotive Company	/wiki/Briggs_Automotive_Company
Brilliance Auto	/wiki/Brilliance_Auto
Brooks Steam Motors	/wiki/Brooks_Steam_Motors
Brush Motor Car Company	/wiki/Brush_Motor_Car_Company
Bufori	/wiki/Bufori
Bugatti	/wiki/Bugatti
Buick	/wiki/Buick
Bulgaralpine	/wiki/Bulgaralpine
Bulgarrenault	/wiki/Bulgarrenault
Burton (car)	/wiki/Burton_(car)
Busscar	/wiki/Busscar
Büssing	/wiki/B%C3%BCssing
CT&T United	/wiki/CT%26T_United
Cadillac	/wiki/Cadillac
Callaway Cars	/wiki/Callaway_Cars
Campagna Corporation	/wiki/Campagna_Corporation
Can-Am motorcycles	/wiki/Can-Am_motorcycles
Carmor	/wiki/Carmor
Cartercar	/wiki/Cartercar
Carver (automobile)	/wiki/Carver_(automobile)
Casalini	/wiki/Casalini
Caterham Cars	/wiki/Caterham_Cars
Ceirano Fabbrica Automobili	/wiki/Ceirano_Fabbrica_Automobili
Chalmers Automobile	/wiki/Chalmers_Automobile
Chandler Motor Car	/wiki/Chandler_Motor_Car
Changan Automobile	/wiki/Changan_Automobile
Changhe	/wiki/Changhe
Checker Motor Corporation	/wiki/Checker_Motor_Corporation
Chernihivskyi Avtobusnyi Zavod	/wiki/Chernihivskyi_Avtobusnyi_Zavod
Chery	/wiki/Chery
Chevrolet	/wiki/Chevrolet
China Motor Corporation	/wiki/China_Motor_Corporation
Chinkara Motors	/wiki/Chinkara_Motors
Chiribiri	/wiki/Chiribiri
Chrysler	/wiki/Chrysler
Cisitalia	/wiki/Cisitalia
Citroën	/wiki/Citro%C3%ABn
Cizeta	/wiki/Cizeta
Clénet Coachworks	/wiki/Cl%C3%A9net_Coachworks
Cole Motor Car Company	/wiki/Cole_Motor_Car_Company
Columbia Automobile Company	/wiki/Columbia_Automobile_Company
Comil	/wiki/Comil
Continental Motors Company	/wiki/Continental_Motors_Company
Cord Automobile	/wiki/Cord_Automobile
Covini Engineering	/wiki/Covini_Engineering
Crawford Automobile	/wiki/Crawford_Automobile
Crosley	/wiki/Crosley
Cutting (automobile)	/wiki/Cutting_(automobile)
DAF Trucks	/wiki/DAF_Trucks
DIM (automobiles)	/wiki/DIM_(automobiles)
DINA S.A.	/wiki/DINA_S.A.
DKW	/wiki/DKW
DKW	/wiki/DKW
DOK-ING	/wiki/DOK-ING
DR Motor	/wiki/DR_Motor
Dacon	/wiki/Dacon
Daewoo Bus	/wiki/Daewoo_Bus
Daewoo Motors	/wiki/Daewoo_Motors
Daihatsu	/wiki/Daihatsu
Dakar 4x4	/wiki/Dakar_4x4
Daniels Motor Company	/wiki/Daniels_Motor_Company
Dartz	/wiki/Dartz
Datsun	/wiki/Datsun
Davis Motor Car	/wiki/Davis_Motor_Car
De Dion-Bouton	/wiki/De_Dion-Bouton
De Tomaso	/wiki/De_Tomaso
DeLorean Motor Company	/wiki/DeLorean_Motor_Company
DeSoto (automobile)	/wiki/DeSoto_(automobile)
Decauville automobile	/wiki/Decauville_automobile
DefTech	/wiki/DefTech
Del Monte Motors	/wiki/Del_Monte_Motors
Delage	/wiki/Delage
Delahaye	/wiki/Delahaye
Delaunay-Belleville	/wiki/Delaunay-Belleville
Delta Motors Corporation	/wiki/Delta_Motors_Corporation
Derby (Canadian automobile)	/wiki/Derby_(Canadian_automobile)
Derways Automobile Company	/wiki/Derways_Automobile_Company
Detroit Electric (company)	/wiki/Detroit_Electric_(company)
Devrim	/wiki/Devrim
Dewan Farooque Motors	/wiki/Dewan_Farooque_Motors
Diardi	/wiki/Diardi
Diatto	/wiki/Diatto
Doble steam car	/wiki/Doble_steam_car
Dodge	/wiki/Dodge
Donkervoort	/wiki/Donkervoort
Dorris Motors Corporation	/wiki/Dorris_Motors_Corporation
Dort Motor Car Company	/wiki/Dort_Motor_Car_Company
Ducati	/wiki/Ducati
Duesenberg	/wiki/Duesenberg
Dupont Industries	/wiki/Dupont_Industries
Durant Motors	/wiki/Durant_Motors
Dynasty EV	/wiki/Dynasty_EV
E-Z-GO	/wiki/E-Z-GO
ELVO	/wiki/ELVO
Eagle (automobile)	/wiki/Eagle_(automobile)
Edsel	/wiki/Edsel
Eicher Motors	/wiki/Eicher_Motors
Electric Raceabout	/wiki/Electric_Raceabout
Elfin Sports Cars	/wiki/Elfin_Sports_Cars
Elgin (automobile)	/wiki/Elgin_(automobile)
Engesa	/wiki/Engesa
Enzmann	/wiki/Enzmann
Erkunt Group	/wiki/Erkunt_Group
Escorts Group	/wiki/Escorts_Group
Essex (automobile)	/wiki/Essex_(automobile)
Etox	/wiki/Etox
EuAuto Technology	/wiki/EuAuto_Technology
Exagon Engineering	/wiki/Exagon_Engineering
Excalibur (automobile)	/wiki/Excalibur_(automobile)
F.L.A.G.	/wiki/F.L.A.G.
FCA Srbija	/wiki/FCA_Srbija
FNSS Defence Systems	/wiki/FNSS_Defence_Systems
FSC Star	/wiki/FSC_Star
FSC Żuk	/wiki/FSC_%C5%BBuk
FSR Tarpan	/wiki/FSR_Tarpan
Fabrika automobila Priboj	/wiki/Fabrika_automobila_Priboj
Fabryka Samochodów Małolitrażowych	/wiki/Fabryka_Samochod%C3%B3w_Ma%C5%82olitra%C5%BCowych
Fabryka Samochodów Osobowych	/wiki/Fabryka_Samochod%C3%B3w_Osobowych
Facel Vega	/wiki/Facel_Vega
Faraday Future	/wiki/Faraday_Future
Farus	/wiki/Farus
Felino Corporation	/wiki/Felino_Corporation
Ferrari	/wiki/Ferrari
Fiat	/wiki/Fiat
Fiat Chrysler Automobiles	/wiki/Fiat_Chrysler_Automobiles
Fiat Chrysler Automobiles	/wiki/Fiat_Chrysler_Automobiles
Fisker Inc.	/wiki/Fisker_Inc.
Flint (automobile)	/wiki/Flint_(automobile)
Force Motors	/wiki/Force_Motors
Ford	/wiki/Ford
Ford Australia	/wiki/Ford_Australia
Ford Performance Vehicles	/wiki/Ford_Performance_Vehicles
Ford-Vairogs	/wiki/Ford-Vairogs
Foton Motor	/wiki/Foton_Motor
Frazer (automobile)	/wiki/Frazer_(automobile)
Freightliner Trucks	/wiki/Freightliner_Trucks
Frontenac Motor Corporation	/wiki/Frontenac_Motor_Corporation
Fábrica Nacional de Motores	/wiki/F%C3%A1brica_Nacional_de_Motores
GAC Fiat	/wiki/GAC_Fiat
GKD sports cars	/wiki/GKD_sports_cars
GM Korea	/wiki/GM_Korea
GM Uzbekistan	/wiki/GM_Uzbekistan
GMC (automobile)	/wiki/GMC_(automobile)
GTA Motor	/wiki/GTA_Motor
Ganja Auto Plant	/wiki/Ganja_Auto_Plant
Gardner (automobile)	/wiki/Gardner_(automobile)
Geely	/wiki/Geely
General Motors	/wiki/General_Motors
Genesis Motors	/wiki/Genesis_Motors
Geo (automobile)	/wiki/Geo_(automobile)
Ghandhara Industries	/wiki/Ghandhara_Industries
Ghandhara Nissan	/wiki/Ghandhara_Nissan
Gillet	/wiki/Gillet
Ginetta Cars	/wiki/Ginetta_Cars
Giocattolo	/wiki/Giocattolo
Glas (company)	/wiki/Glas_(company)
Global Electric Motorcars	/wiki/Global_Electric_Motorcars
Goliath (car)	/wiki/Goliath_(car)
Gonow	/wiki/Gonow
Graham-Paige	/wiki/Graham-Paige
Gray-Dort Motors	/wiki/Gray-Dort_Motors
Great Wall Motors	/wiki/Great_Wall_Motors
Grinnall	/wiki/Grinnall
Grupo Industrial Ramirez	/wiki/Grupo_Industrial_Ramirez
Gurgel	/wiki/Gurgel
Güleryüz	/wiki/G%C3%BClery%C3%BCz
HTT Pléthore	/wiki/HTT_Pl%C3%A9thore
Hafei	/wiki/Hafei
Haima Automobile	/wiki/Haima_Automobile
Hanomag	/wiki/Hanomag
Hansa (car)	/wiki/Hansa_(car)
Haynes Automobile Company	/wiki/Haynes_Automobile_Company
Healey (automobile)	/wiki/Healey_(automobile)
Heavy Industries Taxila	/wiki/Heavy_Industries_Taxila
Heavy Vehicles Factory	/wiki/Heavy_Vehicles_Factory
Heinkel	/wiki/Heinkel
Hennessey Motorsports	/wiki/Hennessey_Motorsports
Hero MotoCorp	/wiki/Hero_MotoCorp
Hindustan Motors	/wiki/Hindustan_Motors
Hino Motors	/wiki/Hino_Motors
Hinopak Motors	/wiki/Hinopak_Motors
Hofstetter Turbo	/wiki/Hofstetter_Turbo
Holden	/wiki/Holden
Holden Special Vehicles	/wiki/Holden_Special_Vehicles
Holland Car	/wiki/Holland_Car
Hommell	/wiki/Hommell
Honda	/wiki/Honda
Honda Atlas Cars Pakistan	/wiki/Honda_Atlas_Cars_Pakistan
Horch	/wiki/Horch
Hradyesh	/wiki/Hradyesh
Hudson Motor Car Company	/wiki/Hudson_Motor_Car_Company
Hummer	/wiki/Hummer
Hupmobile	/wiki/Hupmobile
Hupp-Yeats	/wiki/Hupp-Yeats
Hyundai Motor Company	/wiki/Hyundai_Motor_Company
IDA-Opel	/wiki/IDA-Opel
IKCO (Iran Khodro)	/wiki/IKCO_(Iran_Khodro)
INKAS	/wiki/INKAS
IZh	/wiki/IZh
Ikarbus	/wiki/Ikarbus
Imperial (automobile)	/wiki/Imperial_(automobile)
Indus Motors Company	/wiki/Indus_Motors_Company
Industry of Machinery and Tractors	/wiki/Industry_of_Machinery_and_Tractors
Infiniti	/wiki/Infiniti
Innocenti	/wiki/Innocenti
Inokom	/wiki/Inokom
Inter-State (automobile)	/wiki/Inter-State_(automobile)
Intermeccanica	/wiki/Intermeccanica
Intermeccanica	/wiki/Intermeccanica
International Harvester	/wiki/International_Harvester
Intrall	/wiki/Intrall
Irizar	/wiki/Irizar
Isdera	/wiki/Isdera
Isetta	/wiki/Isetta
Iso (automobile)	/wiki/Iso_(automobile)
Isotta Fraschini	/wiki/Isotta_Fraschini
Isuzu	/wiki/Isuzu
Itala	/wiki/Itala
Italika	/wiki/Italika
Iveco	/wiki/Iveco
JPX (Brazilian company)	/wiki/JPX_(Brazilian_company)
Jackson Automobile Company	/wiki/Jackson_Automobile_Company
Jawa Moto	/wiki/Jawa_Moto
Jeep	/wiki/Jeep
Jeffery (automobile)	/wiki/Jeffery_(automobile)
Jelcz	/wiki/Jelcz
Jiangling Motors	/wiki/Jiangling_Motors
Junior F.J.T.A.	/wiki/Junior_F.J.T.A.
Jösse Car	/wiki/J%C3%B6sse_Car
KTM	/wiki/KTM
Kaipan	/wiki/Kaipan
Kaiser Motors	/wiki/Kaiser_Motors
Kamaz	/wiki/Kamaz
Karma Automotive	/wiki/Karma_Automotive
Karmann	/wiki/Karmann
Karsan	/wiki/Karsan
Kawasaki Heavy Industries	/wiki/Kawasaki_Heavy_Industries
Kenworth	/wiki/Kenworth
Kerala Automobiles Limited	/wiki/Kerala_Automobiles_Limited
Kia Motors	/wiki/Kia_Motors
Kinetic Engineering Limited	/wiki/Kinetic_Engineering_Limited
King (automobile)	/wiki/King_(automobile)
Kish Khodro	/wiki/Kish_Khodro
Kissel Motor Car Company	/wiki/Kissel_Motor_Car_Company
Kline Kar	/wiki/Kline_Kar
Knox Automobile	/wiki/Knox_Automobile
Koenigsegg	/wiki/Koenigsegg
Koller	/wiki/Koller
Korres (Engineering)	/wiki/Korres_(Engineering)
KrAZ	/wiki/KrAZ
LIAZ (Czech Republic)	/wiki/LIAZ_(Czech_Republic)
LaFayette Motors	/wiki/LaFayette_Motors
LaSalle (automobile)	/wiki/LaSalle_(automobile)
Lada	/wiki/Lada
Laforza	/wiki/Laforza
Lambert (automobile)	/wiki/Lambert_(automobile)
Lamborghini	/wiki/Lamborghini
Lambretta	/wiki/Lambretta
Lancia	/wiki/Lancia
Landwind	/wiki/Landwind
Leblanc (automobile manufacturer)	/wiki/Leblanc_(automobile_manufacturer)
Lexington (automobile)	/wiki/Lexington_(automobile)
Lexus	/wiki/Lexus
Li Auto	/wiki/Li_Auto
Lifan Group	/wiki/Lifan_Group
Ligier	/wiki/Ligier
Lincoln Motor Company	/wiki/Lincoln_Motor_Company
Lloyd (car)	/wiki/Lloyd_(car)
Lobini	/wiki/Lobini
Local Motors	/wiki/Local_Motors
Locomobile Company of America	/wiki/Locomobile_Company_of_America
Lohia Machinery	/wiki/Lohia_Machinery
Lozier	/wiki/Lozier
LuAZ	/wiki/LuAZ
Lucid Motors	/wiki/Lucid_Motors
Luxgen	/wiki/Luxgen
Lviv Bus Factory	/wiki/Lviv_Bus_Factory
Lyons-Knight	/wiki/Lyons-Knight
MAN SE	/wiki/MAN_SE
MAVA-Renault	/wiki/MAVA-Renault
MEBEA	/wiki/MEBEA
Mack Trucks	/wiki/Mack_Trucks
Mack Trucks	/wiki/Mack_Trucks
Magna Steyr	/wiki/Magna_Steyr
Mahindra & Mahindra Limited	/wiki/Mahindra_%26_Mahindra_Limited
Manic GT	/wiki/Manic_GT
Marathon Motors Engineering	/wiki/Marathon_Motors_Engineering
Marca-Tre-Spade	/wiki/Marca-Tre-Spade
Marcopolo S.A.	/wiki/Marcopolo_S.A.
Marmon Motor Car Company	/wiki/Marmon_Motor_Car_Company
Martini (automobile company)	/wiki/Martini_(automobile_company)
Marussia Motors	/wiki/Marussia_Motors
Maruti Suzuki	/wiki/Maruti_Suzuki
Mascarello	/wiki/Mascarello
Maserati	/wiki/Maserati
Master Motors	/wiki/Master_Motors
Mastretta	/wiki/Mastretta
Matra	/wiki/Matra
Maxwell automobile	/wiki/Maxwell_automobile
Maybach	/wiki/Maybach
Mazda	/wiki/Mazda
Mazzanti Automobili	/wiki/Mazzanti_Automobili
McFarlan Automobile	/wiki/McFarlan_Automobile
McLaughlin automobile	/wiki/McLaughlin_automobile
Mekong Auto	/wiki/Mekong_Auto
Mercedes-Benz	/wiki/Mercedes-Benz
Mercury (automobile)	/wiki/Mercury_(automobile)
Messerschmitt	/wiki/Messerschmitt
Meteor (automobile)	/wiki/Meteor_(automobile)
Microcar (brand)	/wiki/Microcar_(brand)
Millat Tractors	/wiki/Millat_Tractors
Minardi	/wiki/Minardi
Mitchell (automobile)	/wiki/Mitchell_(automobile)
Mitsubishi Fuso Truck and Bus Corporation	/wiki/Mitsubishi_Fuso_Truck_and_Bus_Corporation
Mitsubishi Motors	/wiki/Mitsubishi_Motors
Mitsuoka	/wiki/Mitsuoka
Modenas	/wiki/Modenas
Modiran Vehicle Manufacturing Company	/wiki/Modiran_Vehicle_Manufacturing_Company
Monarch (automobile)	/wiki/Monarch_(automobile)
Monroe (automobile)	/wiki/Monroe_(automobile)
Monteverdi (automobile)	/wiki/Monteverdi_(automobile)
Moon Motor Car	/wiki/Moon_Motor_Car
Moretti Motor Company	/wiki/Moretti_Motor_Company
Mors (automobile)	/wiki/Mors_(automobile)
Moskvitch	/wiki/Moskvitch
Moskvitch (Bulgaria)	/wiki/Moskvitch_(Bulgaria)
Mosler Automotive	/wiki/Mosler_Automotive
Multicar	/wiki/Multicar
NIO (car company)	/wiki/NIO_(car_company)
NSU Motorenwerke	/wiki/NSU_Motorenwerke
Nakhchivan Automobile Plant	/wiki/Nakhchivan_Automobile_Plant
Namco (automobiles)	/wiki/Namco_(automobiles)
Nardi (carmaker)	/wiki/Nardi_(carmaker)
Nash Motors	/wiki/Nash_Motors
National Motor Vehicle Company	/wiki/National_Motor_Vehicle_Company
Navistar International	/wiki/Navistar_International
Naza	/wiki/Naza
Neobus (Brazil)	/wiki/Neobus_(Brazil)
Neobus (Serbia)	/wiki/Neobus_(Serbia)
Neoplan	/wiki/Neoplan
Neorion	/wiki/Neorion
Neue Automobil Gesellschaft	/wiki/Neue_Automobil_Gesellschaft
New Flyer Industries	/wiki/New_Flyer_Industries
Nexus Automotive	/wiki/Nexus_Automotive
Nikola Motor	/wiki/Nikola_Motor
Nissan	/wiki/Nissan
Nova Bus	/wiki/Nova_Bus
Nyberg Automobile	/wiki/Nyberg_Automobile
O.S.C.A.	/wiki/O.S.C.A.
Oakland (automobile)	/wiki/Oakland_(automobile)
Officine Meccaniche	/wiki/Officine_Meccaniche
Ohta Jidosha	/wiki/Ohta_Jidosha
Oldsmobile	/wiki/Oldsmobile
Oltcit	/wiki/Oltcit
Opel	/wiki/Opel
Ordnance Factory Medak	/wiki/Ordnance_Factory_Medak
Orion International	/wiki/Orion_International
Oshkosh Corporation	/wiki/Oshkosh_Corporation
Otokar	/wiki/Otokar
Otomo (automobile)	/wiki/Otomo_(automobile)
Overland Automobile	/wiki/Overland_Automobile
PGO (Automobile)	/wiki/PGO_(Automobile)
Packard	/wiki/Packard
Pagani (automobile)	/wiki/Pagani_(automobile)
Pak Suzuki	/wiki/Pak_Suzuki
Pan-Car	/wiki/Pan-Car
Pancar Motor	/wiki/Pancar_Motor
Panhard	/wiki/Panhard
Panoz	/wiki/Panoz
Pars Khodro	/wiki/Pars_Khodro
Peerless	/wiki/Peerless
Perana Performance Group	/wiki/Perana_Performance_Group
Perodua	/wiki/Perodua
Peterbilt	/wiki/Peterbilt
Peugeot	/wiki/Peugeot
Piaggio	/wiki/Piaggio
Pic-Pic	/wiki/Pic-Pic
Pierce-Arrow	/wiki/Pierce-Arrow
Pilot (automobile)	/wiki/Pilot_(automobile)
Pininfarina	/wiki/Pininfarina
Pirin-Fiat	/wiki/Pirin-Fiat
Plasan	/wiki/Plasan
Plymouth (automobile)	/wiki/Plymouth_(automobile)
Polaris Industries	/wiki/Polaris_Industries
Pontiac (automobile)	/wiki/Pontiac_(automobile)
Pope-Toledo	/wiki/Pope-Toledo
Pope-Tribune	/wiki/Pope-Tribune
Porsche	/wiki/Porsche
Portaro	/wiki/Portaro
Praga (company)	/wiki/Praga_(company)
Premier Automobiles Limited	/wiki/Premier_Automobiles_Limited
Premier Motor Manufacturing	/wiki/Premier_Motor_Manufacturing
Prevost Car	/wiki/Prevost_Car
Prince Motor Company	/wiki/Prince_Motor_Company
Proto Motors	/wiki/Proto_Motors
Proton (automobile)	/wiki/Proton_(automobile)
Puch	/wiki/Puch
Puma (car manufacturer)	/wiki/Puma_(car_manufacturer)
Pungs Finch	/wiki/Pungs_Finch
Qoros	/wiki/Qoros
Qvale	/wiki/Qvale
RCH (cars)	/wiki/RCH_(cars)
REO Motor Car Company	/wiki/REO_Motor_Car_Company
Ram Trucks	/wiki/Ram_Trucks
Rambler (automobile)	/wiki/Rambler_(automobile)
Rauch and Lang	/wiki/Rauch_and_Lang
Redpath (car company)	/wiki/Redpath_(car_company)
Regal (automobile)	/wiki/Regal_(automobile)
Renault	/wiki/Renault
Renault Samsung Motors	/wiki/Renault_Samsung_Motors
Riga Autobus Factory	/wiki/Riga_Autobus_Factory
Rimac Automobili	/wiki/Rimac_Automobili
Rinspeed	/wiki/Rinspeed
Rivian	/wiki/Rivian
Robur (truck)	/wiki/Robur_(truck)
Rocar	/wiki/Rocar
Rochet-Schneider	/wiki/Rochet-Schneider
Roman (vehicle manufacturer)	/wiki/Roman_(vehicle_manufacturer)
Rossion	/wiki/Rossion
Royal Enfield (India)	/wiki/Royal_Enfield_(India)
Russell Motor Car Company	/wiki/Russell_Motor_Car_Company
Russo-Balt	/wiki/Russo-Balt
S.P.A. (automobile)	/wiki/S.P.A._(automobile)
SAIC Motor	/wiki/SAIC_Motor
SAIPA	/wiki/SAIPA
SCAT (automobile)	/wiki/SCAT_(automobile)
SEAT	/wiki/SEAT
SNVI	/wiki/SNVI
SSC North America	/wiki/SSC_North_America
Saab Automobile	/wiki/Saab_Automobile
Saehan Motors	/wiki/Saehan_Motors
Saker Cars	/wiki/Saker_Cars
Saleen	/wiki/Saleen
SamKochAvto	/wiki/SamKochAvto
Samsung Commercial Vehicles	/wiki/Samsung_Commercial_Vehicles
Santa Matilde	/wiki/Santa_Matilde
Sarao Motors	/wiki/Sarao_Motors
Saturn Corporation	/wiki/Saturn_Corporation
Sazgar	/wiki/Sazgar
Sbarro (automobile)	/wiki/Sbarro_(automobile)
Scania AB	/wiki/Scania_AB
Scripps-Booth	/wiki/Scripps-Booth
SeAZ	/wiki/SeAZ
Sfakianakis	/wiki/Sfakianakis
Shelby American	/wiki/Shelby_American
Shinjin Motors	/wiki/Shinjin_Motors
Siata	/wiki/Siata
Sibal (car)	/wiki/Sibal_(car)
Simca	/wiki/Simca
Simplex (automobile)	/wiki/Simplex_(automobile)
Simson (company)	/wiki/Simson_(company)
Smart (marque)	/wiki/Smart_(marque)
Società Torinese Automobili Rapid	/wiki/Societ%C3%A0_Torinese_Automobili_Rapid
Sofia (car)	/wiki/Sofia_(car)
Sohrab Cycles	/wiki/Sohrab_Cycles
Solaris Bus & Coach	/wiki/Solaris_Bus_%26_Coach
Sollers JSC	/wiki/Sollers_JSC
Soueast	/wiki/Soueast
Speedwell Motor Car Company	/wiki/Speedwell_Motor_Car_Company
Spijkstaal	/wiki/Spijkstaal
Spyker Cars	/wiki/Spyker_Cars
SsangYong Motor	/wiki/SsangYong_Motor
SsangYong Motor	/wiki/SsangYong_Motor#Keohwa
Standard Motor Products of India	/wiki/Standard_Motor_Products_of_India
Stanguellini	/wiki/Stanguellini
Stanley Motor Carriage Company	/wiki/Stanley_Motor_Carriage_Company
Star (automobile)	/wiki/Star_(automobile)
Stearns-Knight	/wiki/Stearns-Knight
Sterling (car)	/wiki/Sterling_(car)
Sterling Trucks	/wiki/Sterling_Trucks
Stevens-Duryea	/wiki/Stevens-Duryea
Stoddard-Dayton	/wiki/Stoddard-Dayton
Stoewer	/wiki/Stoewer
Storero	/wiki/Storero
Street and Racing Technology	/wiki/Street_and_Racing_Technology
Studebaker	/wiki/Studebaker
Studebaker	/wiki/Studebaker#Hamilton.2C_Ontario_plant
Stutz Motor Company	/wiki/Stutz_Motor_Company
Subaru	/wiki/Subaru
Suzuki	/wiki/Suzuki
Swaraj Mazda	/wiki/Swaraj_Mazda
Syrena	/wiki/Syrena
TOGG	/wiki/TOGG
TVS Motor Company	/wiki/TVS_Motor_Company
TagAZ	/wiki/TagAZ
Talbot	/wiki/Talbot
Tangalakis-Temax	/wiki/Tangalakis-Temax
Tata Daewoo	/wiki/Tata_Daewoo
Tata Motors	/wiki/Tata_Motors
Tatra (company)	/wiki/Tatra_(company)
Tauro Sport Auto	/wiki/Tauro_Sport_Auto
Tecnologia Automotiva Catarinense	/wiki/Tecnologia_Automotiva_Catarinense
Tempo (car)	/wiki/Tempo_(car)
Temsa	/wiki/Temsa
Terradyne Armored Vehicles Inc.	/wiki/Terradyne_Armored_Vehicles_Inc.
Tesla Motors	/wiki/Tesla_Motors
Thaco	/wiki/Thaco
Thai Rung Union Car	/wiki/Thai_Rung_Union_Car
Theologou	/wiki/Theologou
Think Global	/wiki/Think_Global
Thomas Motor Company	/wiki/Thomas_Motor_Company
Tofaş	/wiki/Tofa%C5%9F
Tommy Kaira	/wiki/Tommy_Kaira
Toroidion	/wiki/Toroidion
Toyota	/wiki/Toyota
Trabant	/wiki/Trabant
Tractors and Farm Equipment Limited	/wiki/Tractors_and_Farm_Equipment_Limited
Tramontana (sports car)	/wiki/Tramontana_(sports_car)
Trekka	/wiki/Trekka
Troller	/wiki/Troller
UAZ	/wiki/UAZ
UD Trucks	/wiki/UD_Trucks
UMM (União Metalo-Mecânica)	/wiki/UMM_(Uni%C3%A3o_Metalo-Mec%C3%A2nica)
Uniti (car)	/wiki/Uniti_(car)
Uro (trucks)	/wiki/Uro_(trucks)
Ursus Tractor Factory	/wiki/Ursus_Tractor_Factory
VDL Berkhof	/wiki/VDL_Berkhof
VUHL	/wiki/VUHL
Valmet Automotive	/wiki/Valmet_Automotive
Van Hool	/wiki/Van_Hool
Vandenbrink Design	/wiki/Vandenbrink_Design
Vector Motors	/wiki/Vector_Motors
Vehicle Factory Jabalpur	/wiki/Vehicle_Factory_Jabalpur
Vehículos Automotores Mexicanos	/wiki/Veh%C3%ADculos_Automotores_Mexicanos
Velie	/wiki/Velie
Velorex	/wiki/Velorex
Vencer	/wiki/Vencer
Vespa	/wiki/Vespa
Vignale	/wiki/Vignale
VinFast	/wiki/VinFast
Vinci (automobile)	/wiki/Vinci_(automobile)
Volga (automobile)	/wiki/Volga_(automobile)
Volkswagen	/wiki/Volkswagen
Volvo Buses	/wiki/Volvo_Buses
Volvo Cars	/wiki/Volvo_Cars
Volvo Trucks	/wiki/Volvo_Trucks
W Motors	/wiki/W_Motors
Walter Fiat	/wiki/Walter_Fiat
Wanderer (car)	/wiki/Wanderer_(car)
Warszawa (car)	/wiki/Warszawa_(car)
Wartburg (car)	/wiki/Wartburg_(car)
Westcott (automobile)	/wiki/Westcott_(automobile)
Western Star Trucks	/wiki/Western_Star_Trucks
White Motor Company	/wiki/White_Motor_Company
Wiesmann	/wiki/Wiesmann
Willys	/wiki/Willys
World Auto	/wiki/World_Auto
Wuling Motors	/wiki/Wuling_Motors
Xpeng	/wiki/Xpeng
Yamaha Motor Company	/wiki/Yamaha_Motor_Company
Yamaha Motor Pakistan	/wiki/Yamaha_Motor_Pakistan
Yo-Mobile	/wiki/Yo-Mobile
Yulon	/wiki/Yulon
ZAZ	/wiki/ZAZ
ZENN Motor Company	/wiki/ZENN_Motor_Company
ZSD Nysa	/wiki/ZSD_Nysa
Zagato	/wiki/Zagato
Zanella	/wiki/Zanella
Zastava Automobiles	/wiki/Zastava_Automobiles
Zastava special cars	/wiki/Zastava_special_cars
ZiL	/wiki/ZiL
Zimmer (automobile)	/wiki/Zimmer_(automobile)
Zotye	/wiki/Zotye
Zundapp	/wiki/Zundapp
Zust	/wiki/Zust
Zwickau (car)	/wiki/Zwickau_(car)
Özmaktaş-Özaltın Makina Otomotiv	/wiki/%C3%96zmakta%C5%9F-%C3%96zalt%C4%B1n_Makina_Otomotiv
Škoda Auto	/wiki/%C5%A0koda_Auto
